11111111111111111111111111111111111111111111111111
1C00000X0000000C00000C0000000000000000000000X00001
1010010100100000101001000000P1010000000000000X0001
1010010010101010001001X0000001010000000000000X00E1
100000000C00C0000000000X00000000C00000000000000X01
10000010000000000000X000000000000000000000000000C1
1010000000C00000000XC000000C00000000000000000000C1
10C0X1C0010000000000X000000000000000000000000000C1
11111111111111111111111111111111111111111111111111