1111111111111
10010X00000C1
1000011X11001
1P0011E000001
1111111111111